@wwwwwwwzwwwwwwwwwww
w..................w
w......w...........w
w..................z
w......E..bbbbbbb..w
w......B...........w
z.......S..........w
w..................w
w..................w
w..................w
w..................w
w..................w
w..................w
wwwwwwwwwzwwwwwwwwww